5 10
|--------|
|FF.|..-.|
|FF-|.@P.|
|..F...-.|
|--------|