5 10
|--------|
|...|..-.|
|..-|.@..|
|......_.|
|--------|